0000100000000000001000000000000000000000000010000001000000000000000000100000000000100000000000000000
0000000000000000000100000001000000000000000000000000010000000000000000000000000000000001000000000000
0000000000000000000000000010000000000000000000000000000000000000000000000000000000000010010000000000
0000000000000000001000000000010100000000000000000010000000000000000000000010000010000000000000010000
0001001000000000000001000000000000100100000000000000000000000000000000000000000000000000000000000000
0000001010100000000000000010000100001000000000000000000000000010000000000000000000000000100000000000
0000000000000000000000000000000000000000000000000000000000001000000000000000000000000000000000001100
0000000000100000000000000000000010000000001000000000000000000000000010000000000000000000010000000000
0000000000000000000000000010000000000000000000000000000000000000000000000000000000001000000000000110
0000000000100000000010110001000000000000010000000000010000001000000010000000000000000000000000000000
0000010000000000000010000000000000000001000000000100000000000000000000000000000000000000000000000000
0000000000000000000000000000001000000000001000001000000000100100001000000000000000000010100000000000
0010000100000000000010000000000000000001000000000000000000000000000001000000000010000010001000000000
0000100100000000000000000000000000000000001000000000000100000000000000000000000001000000000000001000
0000000000000001000000000010000100000001100000000000000010001000000000000000001000000000000000000000
0000000100000000000000000000000000000000000000000000000000000000000000000000000000000100000010000000
0010000000000000010000000001000000000000000000010000001000000000000000000000000000000000000010000000
0000010000000010000000001000000000000000000100000000000000000000010000000000000000000000001000000100
0000000000000000000000000000000000000000000001000010000000000000000000010000000000000000000000000000
0000010000000000000000000000000001000000000000000000000000001000000000000000000000000000000000001100
0000000000001000000000000000000001000001000000000000000000000000000000000000000010000000000000000000
0000000000000000100000000000000000000000100000000000000000000000000010000000000000000000000001000100
0000000000000000000000100000000000000000000000000000000000000000000000000000000000000000000000000000
0000000000000000000010000000000000000000000000000000100000000000000000000000000000000000000000000000
0000000000000001000000000000000000000010000000000100000000000000000000000000000010000000000000000000
0000000000000000100000000000000000000000000000000000000000000000000000000000000000000000100000000000
0000000000000000000000100000000000000000000000000000000000000000000000000000000000000000001000000000
0000000000000000000000000100000001000000100000000001000000100000000000000000000000000100000000000000
0000001000000000000000000001000100000000100000000100001010000000000000000100000100000100000000000000
0000000000000000000000000000010000000000010000000000000000000000000000000000001001000010000000000010
0000000000000001100000000000000000000001000100001000000000000000000000000000000000000000000000000100
0000000000000001001000000000000000010000000001000000000000000000000000000000000000000000000000000000
1000000000000000000000000100010000000000000001000000000000000000000000000000000000000100000100000000
0000000000001000000000000000100001000010000000000000100000000100000000100000000000000001010000000000
1001000000000000000000000000010000100000000000000010100000000000000000000000000000000100000000000000
0000000000000000000100000000000000000001000000000000000000000000000000000000000000000000101000000000
0001000000000100100000001000000000001000000001000000100010100000000000000000000100010000000000000000
0000000000000000000000000000000000000000000000000000000000000000000000001000000100000000000000000000
0000000000000000000000000000000000000100001000000000000000000000000000000000000000000100000000100000
0000000000000000000000000000000000000111000100000000000000000000000000000000000000000000100000000000
0000000000000000010000000000001000010000000000000000000000000000000000000000000000000000000000000000
0000000000000000000000000000000010000000100000000000000100000110010000000000000001000000000000000000
0000000000000000000000000000000000000000000000000000100001000000000000010000000000000000000000000000
1000000000000000000000000000000000000000000000000000000000000000000010000000100000110000010100000000
0010000000000100000000000000000001000000000000000000000000100100000000000000000000000000000000000000
0000000000000000001000001100000100000000000000000000000000000000000000000000000000000000000000000000
0000000000100000000000100000000000001000000000000000000000000000000000000000000000010000000100000000
0010000000000000000000000000000000000000000000000000000001010000000000000000000000000000000000000000
0000010000000000000010000000000000000000001000000000000000000000000100000000000000000000000000000000
0000001100000000000000000000000000000000100000000000000000000000000000000001000010000000000000000010
1000000000000000000001010000000000000010000000000000000000010010000000000000000000000000000000000000
0000000000000000000000000000000000000000000000000000100000000000000100100000000000000001000000000000
0000000000000000000000000010001000000000000000000000000000000000000000000100000000000000000010000000
0000000000000000000000000001000000000000000000000000000000000000000000000000000000000000000000000000
0000000010000000000100001000000000000010000000000000000000000000000000010000000010000000000000000010
0000000000000000011000100001000000000000000000000000000000000000000000000000000000000000000000000000
0100000000000000000000001000000000000100000000000000000000000000011000001000000000000000000000001000
1000000000000000000000000000000000000000000000000000000001000000000010000000000000000100000000000100
0000000000000100000000000000000000000000000000000000000000000000000000000000000000000000000000000000
0000000100000000000000000000000000000000000000000000000000101000000100000000000000000000000100000000
1000000000000000010000000000000000000000000001000000001001000000100000000100000000000100000000000000
0000000000000000000000000000000000000000000000000011000000000000001000000001000000000000000000000000
0000000000100000000000000000000000001000001000000000000010000001000000000000000000000100000000001000
0000000000000000000000000000000000000000000000000000000000000000000000000100000000000000000000000000
0000000000100000000000001000011000000000000000000000000000000000000000000000000000000000000000000000
0000000000000000000000010000000000000000000001000000010000000000000100000000001000000000100000000000
0000000000000000000000000010000000100001000000000000000000000000100000000000000000000000001010000000
0010000000000000000000000000000010000000000000000000000000000000000000000000100000000000000000000000
0000000000000000000000000000000100000000000000000000000000000000000000000000000001000000000100000000
0010000000000001000000001000000000000000000000010000000000000000000000000000000000000000000100000000
0000000000000000000000000000000010000000000010000000000001000000100000000000000000000000000100000000
0000000000000000000010000000010000000000000000000000000000000000000000000000001000000000000000000000
0000000000000000100000000000000000100000010000000000000000000010010000000100000000001000000000010000
0000000000000010000000000100000000100000000000000000000000000000000010000100000000000000000000000000
0000000000000000000000000000000000000000000000000000000000000110000000000000001000000000000000000100
1000000010000010000000000000010000000000010000000000010000000000000000000000000100001000000000000000
0010000000000000000000000000000000000000000000010000000001000000000000000000000000000000000000000000
0000000000000000000000000000000000000000000000000000000001000000000000000000000000000000000000000000
0000000000000000001000000000000000100000000000000000000000000001000000000000000000000000000000000000
0100000000000000000000100000000000000000000000000000000000010000000000000000000100000000000000000000
0001000000000000000000000000000000000000000001100000000000100000000000000000001000100000000000000010
0000000000000000000000000000000000000000000000000000000000000100000000000010000000000000010010000100
0000000000001100000000000000000001000000100000000001000000000000000000000000000000000000000000000000
0000000000000000010000000000000000000000001000000000000000000100000000000000000011000000000000000000
0001000100000000000000000000000000000000000000000000000000000000000000000000000000000000000000000000
0000000010000100000000001000000000000000000000000000000000001000000000000000000000000000000010000000
0000000000100000000000000000000000000000000000000000000000010000000000000000000000000000000000010000
0000000000000011000000000000000000000000000010000000000000000000000000000000001100000000000000000000
0000000000000000000000001100000000000001000000000000000000000100000001000000100000000100000000001001
0000010000000000100000000100000000000000000000000001000000001100000000000000000000011000000000000000
0000000000000000000000000000000000000000000000000000100000100000000000000000000000000000000000000000
0000000001000100000000000000000010000000000000000000000000000000000000000000000000000000000000000000
0000000000000000101100000000000000000000100000000000000000000000000100000000100000000010000000000010
0000000000000000000100000000000010000000000000000000000000001000000000000000000000000000000000000000
0000000000000000000000000000000000000000000000000000000000000000010000000010000000001000000000000000
0001000000000100010010010000000000000000000000000000000001011000010000000000000000000000000000001000
0000100000100000000100010000000100100000001000000000000000000010010000000010000000100000000001000000
0000000001000000001001000000000000000000000000000000100000000000010000000000000000000010000000000000
0000000000001001000000000000000000000001001000000000000000000000000000000000000000000000000100000000
0000000000000000000000001000000000000000000001000001000000000000000000000000001000000000100000000000