0000000000100000000100000000000000000000000000010000000100000000000000000000000000000000000001100001
0000000100000001000000000000010010001000010010000000000000100010000000010100000000000000010000000000
0000000000010001000000100000000000001000000100000000000000000000000100000010000000000000000000000110
0000110000000010000100000000000000100101100000010000000000100000010010001000000000000000001010000000
1000000000100000000100000000000000000001000000001000000001000000100000000000000000000000000000000000
0100000001000010000000000000000000000000101001000001001000000000000000001100000000000000000000000000
0000001101010000001000000100000000000000001000000010000000000000100000000000000000000000000000000100
0000000100000000000000000000000000100000001100000000000000010000000000000000000000000010100000000000
0000000000000000000000000000000100000000000000000000010000000001000000011000010000000010000000010000
0000001000000000010100000000000000000001000000000000000000000000001000000000000100010000000100000000
0010101000000100000000010000000000001000000000000100000001000000000000101000000000000000000001000000
0000000000000010000010000000000000000000000000000000000000000000000010000000000000000000000001000100
0000000000000000000000000000010101100000000000000000001000000001100000000000000000000000000000010000
0010000000000101000000000001000010000000000000100000001000010000000000000000000010000010100001000000
0000001000000000100000000100000000001000000000000000000000001000000000010000000100000000000000000000
0000000000000000000010000000001101000000000000000000000000000000000100000001000000000000000000000000
0001000000000000000000001001000100000010100000001001000100000000000010000000100000000010000000000000
0000000000000000000100110100000000010000000000000000000001000000000000000000001100000100000000000001
0010011010001100000000000000001000010000000000000001100001000000000000000000000000000010000000000001
0100000100000000000000000000000100000000000000010110000010000000100000000000000010000010000000011100
0000000010000000000000001000000000110000100000100100000010001000000000000000000000000001011100000000
1000000000001101000000000010010000000000000010010000000100000100000000000000000100000000000000000000
0010000000000000001000000000000000000000000000000000001000000000010000010000010000000000000000000010
0000000011000000000101000000000000000001000000000000000001000000000100000011001000000000000000010100
0000000000010000010100000100000100001000100000100010000000001000000000000000000000000000001000000000
0000000000010101000010000000000001000001000000000100001000000010010000000000000000010000000000010000
0001000100000010000000000000000000000000000000000000000001000000000000000000000000010000001000000000
0100000000000000000100001000101010000000000000000100000000000000000000100000000000011000000000000000
0000000000010000000000001000000000000000000000000101000000000000000001000010001100001000000000000000
0011000001000001000100010000000000000101100000000000000010000000000010010000000000000000000010000000
0000001000000000000000001000000000000000001100000010000000000100000001000000000010000000001000000000
1000001000000000000000001000000000000000000001000000000000000000000000000000000000000000000010001000
0000000000110001000000000000000000000000001101000100001000000110000000000000000000000000000000010001
0000000010000000000000000000000100000000000000000001000110000000010000000001010010000000000001001000
0000100010000001100010000000000000100000000000000000000000000010000000000000000000000000001001000000
0000000000100000000000000000000000000000000000001000001000000000000000010000000000000000000010001000
0000001001000010000000000000010000000000000000000000000000100010000000100000000000000000001000110000
0000010000000000000100000100000000000000000000000000000000100001000000001100000000000000000001000000
0000000000000000100000010000000000000000000100000000000000000000000000000100000000000010000000100000
0000001001000011000010000000000000000000000000100000010000100000000000010010000100100000000000000000
0000001000000000101000000000001000000000000000000000000001000000000010000000010000010000010000000000
0101000000100000000000000000000000000000001010000000010000000000000000000000010000000000110000000000
0000100101000000000000000000000000000000000000000000000010000000000000000100000000000000000000000000
0000000000001000001000001000100000000000000000000001010000000100000000000000000000000100000000000000
1000000000010000000100000100000000000010001000000000001011000101000010000000010000000000001000000001
0010000000000000001001000000110000000000000100000000000000000000000000001000000000000000000001001001
0000000110000000000000000000000010010010010000000000001000000000000001001010000000000000000000100100
0000100000010000100000000100000000100000000000001000000000000000000000000000000000000000000100000000
0000000000010000000000000000000000000000000000000000100000000000000010000000000100110000000000000100
0000000100000000010000100001000101000011000000000011010000100000000001000001000000000001000000000100
0000100000000000000000000000010000000000000000000000001000000110000001000000000100000010000000000001
0100000000000000000001000000001000000000001000000000000000000000000000000000000000110000000000010000
0001000000000000000000010000011000000100000000011000011000010000000000000000000000000000011000000100
0000000000010000000001000000001000000000000100000000000000000000001000000000000010000000000000100100
1000000000000000001000000000000000000000101000000000000000100000000000100000000001010000000010010100
0000000001000000000000110011000001000000000000000000000000000000001000100000000000000000000000000001
0000000010100000000000000000000000010000000000000010100000010000000000000000000000000000000000000000
0000100000000010011000000000000100001000000000000000000000000000001000000000000000001010000000100000
0010000000000000000000000000000000001000100000010100100000000100000000000000000000010000000000000000
0000000000000000000000000000000100000000100000000000000000000000010000000001011000000000000000000001
0100000000000001000000000000100100000000000100010000000000000000000000000000000000000000000000000010
0000000010000001000000000100000000000000000000010000000010000000000000000100000000000000000000000000
0010100000000001010100000000000000010000000000000000000000000000000000000000000100000000000000000100
0000000000000000000010000000000000001000001000000100000000010001000000010000000110000001001000000101
0101000001011000000000000001101000000001000001000000000010000000010000000000000000000000010000100000
0000000000000000000000000000000000000000000000000000000100000000000000000000000001000000000000000000
0000000000000001000010000000100000000000000000000000000000000000000000001000000000000000000000010010
0100000000000000000000101010010101000111000000010000000010000000100000000000001000010000000000000000
1000000100000001001000010000000000000000010000000111000000000000010000000000000000111000010000000000
0000000000001000000101000000000000000000000000000110000000000000000010000001000000000000000000001000
0001010001000000000101000000000001000000000000000010000100001000000000000010000010001001000000100100
0001000000000000000001000000010000000000000100000000010000000000000000100000000000000001001000000011
0100000000000000000000000010000000100000000000110000010000000000000010000001100010000000100000000100
0001000000000001000000000000010000000000000000000001000000000000000010000010000000000001010000000000
0000000101000001000001000000000000000000000010000000000000100010000000000000000000000000000000000000
0000010100100000110001000000001000100100100000010000000000000000000000000001000000000100000000000000
0000000000000101100000000000000000010000000000000000000001010000000000000000000000000000000000000000
0001001000000000000101000000000000000000000010000000000000001000000000000000000000000000000001000000
0000010000111100000100000000000000000000000000000001000000010000000000000100001000000010100000010000
0000000100000000101010000000000000000000000000000000100001010000100100000010000000000100100000000000
0000010000000000000000000010100001000100000000001000100000000000000000000010000100100000000001000000
0000001000000000010000000000000000000000000000000001000000000000010000000000010000110000001000000000
0000000000000000100000000010000000010000010100000000000110000000010000000100000000000000000000000010
1001000001100010001000010010000110000000000100010000100001000000000000100000001000000000000000001000
0000011001100000000000000000000000000000001000000001000000100000000000000000001000000001000000001000
0001001001010001100100010100000100001000000010001010000000000000000010001000010000000000000001000001
0000000000001100010000000000010000000000000000000000000000000000000000000000000000010000000000000111
0000100000001100000000000000000010010010000000000000000100011001000000000100000000000000000000000000
1000000000101101000000010100000000010001000001000100000100000000001000000000000000000000000000000000
0000000000000000000000010000000000010000000000000000000001000001000100011000000010000100000000000000
0000010100000000000100100000000000001000000000000000000100010000100100010010000100101000000000000110
1000000000000000000000100000000000000010000010000110000000000010000000000000010000000000000000000000
0000000000000001100000000010000000000100010000000000100000000000010000000000001000101010000001000000
0100000100100000000000000010000000010001000000000000000000000000000100100000001001010000001100000000
1000000000000000000000000000010000000001000000000010000010000000000000000010100000000000000000000000
0100000000000000000000000000100100001000100000000000000001000000010000000010100000000000010100000000
0000000000000000000000000000000000000000000000000000010000000000000000001000000000100000001000000011
0010000000011000000000010000001000000000000000001000000000001000000000000010101000000001011000000000
0000000010000000000000000000000000000000000000000000010100000010000000000000000000100000000010000000
0000010000000000001000000010000110000010000100000000000000000000001000100000100000000000000000000000