0000000000000000000000000010000000000000110000000000000000010000100000000000000000001000000000001000
1000100001000000001000100010000000000001000000000000000000000000101000100001010010100000000000000000
0000010111011000100000000011000001100000100100010000000000000110000011000000000000100000000001000000
1000000000000000000100000100000100000000000000100010100000000000000000000100000000000000010000100001
0000000000000010000000000000001010000001000000000100100000101100000000000100001101010000000000010000
0100000111001000000000001000000000000000010010000000001000000000000000000100000001000001000000000000
0010100001010000010000000000001100010000100000000100100000000000000001000100010000100100010000101000
0000000000011000000000000010000000010101000000000001000101000000100000001000001100000000000010000000
0000010001100010110000000000000010001001000001000001000100000000000001000011010010000000100000000010
0001000100100010000001010000000001000000001000011000000100000000000001001000000000000000000000110000
1000000000000001110000000000000000000000010000011100000000001010001000001100000100100001000010010000
0001000010000010010000000000000010000100000000010000001011000101000100000000000100000000000100000000
0000011001010001001000010001010001001001000110000001000100010000000000011100000000000000100000000000
0000100000000000000000000010000000000011000000001000000000000000000000000001001010000000100000010000
0000000000100000000000000001100000000000000001000000000000001001000100010000000000000000000000001000
0000000000010001000000001000000000000010100000100000000001000100000000001000000000100000000100010000
0110000000000000000000000000001101001000010000000000000110000100000000000010010010000100000000000100
0000000100010000010000000000000000100000000010000000100100010000101000000000000000000100000111000000
0000000000001000101000101010010010001001100001010010011000000000000000000100000000000001000100000001
1000001010100001001000000000000000000000011000000001010001000000000000000011100000001000000010000000
0100000100000000000000100000000000000000100101000010010000000010010000001000000000000000010000010000
0000001000000000000010000000010010000100000100000000000000100000000100000010000101000000000000110001
0010000010000100100000001111000110000101000000000000000000000000010000001000101000000001000000001000
0000010010110000010000000000000000100000000001011000001001000001100000010000000000000100100000000001
0010000000000000000000010000100000000100000000000000010001000000000100000000010100010000000001100000
0000000001110101010010000010000010000000010100101001001001010010000000000000100001000001000000010000
1100000000011001000110000001001100100000000000000000000000000000010000000000101001000100000000000000
0000000000100010000010000010010010000000000000001001000001000000001010010000010000000000000100000100
0000000010000000001000000000010010010000001000000101000000100100000101000100001100100000000000000000
0000000100000000001000000000010000000000001100000000000000100000000000000100000000000010000010011000
0010000000000010001000000010000010001000000000000100000000100000000001010001000000000010010000000000
0000000000110000000000000000000000000110000000000000110100000000000000001000000010000000000000000000
1000000010010000001000000100000000000000000000010000000000000000001000000000100000000000000100000000
0010010000000100000001000000000000000000100000111000000000010000000100000001000000000010100000110000
0001000000011000011000010010100000100000000000100000000000000011010000000100010101010000000000001000
1001001001000001000101000000001000000000000000001000000000100000010000010000000000000000000000001000
0100000000000001000000110000010010000010000010000000100001010100010000010001010000000010000010000000
0000000000001000000001000000100000000000000001000000000000010000010000001010000001000000000001001100
0000000000000000000100000010001000000000010000000000000000001001000000000001000000001000000100100000
1000000000000000110000010000110100000001001100000001001100000000000000000000001010000001100000010000
0000000010100000000010001100000000001001000100010100000011000001000000100000100000000000000000000000
0000000000000000000000100000010000000000000000000000110000000000000000001000010100001000000001000000
0100000000000001001000100000100000000001000010000000000010001010001000001000000000100000000000000010
0000000000010010000000000001010100000000000010110001000000000100000000010100010100111000000001000000
0000000001100000000001010001001000000001100000100000000000100001000100000000001000011000011000000000
0000000100000000000001000000000000010110000000100110100100000000000000000000000000000011001000100000
1100000000001000010000001001000000010100001000101000000001110100000001000000000000000000000000110010
0000000010000000000001000000000100001000000010000000010010000000000001000001000000000000000000000010
0000000000000000010011000010000000100000010000100000000001010000000000100000000000000100000010000011
1000001010000000000010110000000010001000000000000000000000110100000000001100000000000101000001100000
0000000000000000001010010000000000000000000100001011000001000100001100001000000000010010000000001000
0000010000000000000000000001000000000000001000001000100000110000000011100010001010000000000000001000
0000000010000101000000001000001100000000010001001000010000100100000001011000000000100100000011001010
0000000000000100000000001100010000000000001100010000000001101010000001000000000000010000000000000110
0000100000100000000000000101100000000000000001000100000000000000000010000000100000001001100010000000
0001000000100000100000000000000000000000010000101000100000000001100000010001000010001000000010000000
0000000100100000000000000000000000000000000000000100000000110000000100100000000001010000100000000100
0100100010100010001000010000010000000001000000000000000000010000011000000010000000000100000000100111
0000000000000100000000000000000000000100000001000000001000000010000000100000010000000000001000000001
0110000000000000000010000000001000000111110000000000000000001000100010100000010000000000001001001000
0100101000000000010010000110010000000000100000000110000000000000000110000000000000100000001000000000
0000000110001000001000011000000000010000000100010000010101000000000000110000001000000000000100001000
0000010000000000001000000000000000000000000000110100000100000001000001000001000000001000000000000000
0000000000000000100000000100000100100000000010100000001000001000000000000000001000010000011100000100
0100010000010000000100000000000000010000000000100000000000001001001000000000001000100000100100000000
0000001000100010000000000001100000000000100000000000000000000000001001000100000001010001100000101100
0100001000000000000110010000100001000010000011010001001000000000001110001000000000001110101000001000
1001000000001000001000000100010000000000000000000000000000000000000010100101000000000000010000000000
0000000000000000001000000000000000000010011010000000001101000000000000100001000000110000000101000000
1011000100000001000000000000000000001000000100000110001000000010000001100010000100000100000000000010
0000000000001000001000000000001000000000000000000000111000000000000000001000010010000000000000010000
0010001100000010100010000000000010000001000000000000010000000000100000100000010000000000100000000000
0000000010000000001000000001000100100000000001000000010000000001100000000000000000000000100001000000
0000000000000000010100000001001110010001001000000010000001000100000100001010000000000001001000000100
1000000000010000000000000000000000110000100000011000000001100110000000000000000011010000010100000000
0000000000100000000000000000000000010001000010000000001000000010100000010000000000010000000100000010
1000000000100001000000000100000000000011110000010000000000000010101001010101001001000001000100000010
0001000000000100000000000000001001000001000000000000001010000000000000100000000000100000000000100000
0000000011001000100000000000000000000000000000010000000000000010000000000000000101000000000000000000
0000000000100010110000000100110000100001000000001000000000000000000100000100000100000000001000011000
0000001000000000000000000001001100010001000010010000000000000100000000000101000000100000000101000000
0000000000000101000000000010001000110000000000000000000010000001001001000000000001100000100000010000
1001110000000000000000000000000000101000010000100001000000110000000000000000000000000001000000000100
0001011000000000111000001001000000000000000000001000100100000000000100000001100111110000000000000000
0000001000001000000000100000000000001100010000010000000000101000000000000000000100000000100000101000
0000100000000100000000000000110000000000001000100000010000000000000000000000000000001000110000010000
0100100000000000100000000100000001000000000000010000000100011000000001010100000000100000001010000000
0000001000001001000101000000000000010100000000000000000000000010001100000000110000001000001011001000
0000100000001000000000100100100000100000001001000000000000010000000000000000000000000000000100001000
1001000110000000000110000111001000100000000001000000001111010010001000010000000011000001000000010000
1000100000000000100000000000000000000001100101100000101010000000000000001010110100000000000000000000
0000000000000100000000100000001000000110000000000000000000000000100010000000000000001000100001000000
1000000010010000000001000000010000000000000000000000100000000000000000000010001000010000000000000000
1000100100000001000000000000000000000100000000000000000001000000000001000000000010001000000000000001
0010000001010000000101000000000000100000000000001010000000000010000000101000000000000100001000000000
0000000000010100000011010000000010000000110000000000000000000100000000100000000101000000000100000000
0000000000000000000110100000100000001000000000000000010000010101000010000010000000000000000101000001
0000000000000100000000000000000000000000100000100000110000000000000000000000000001001000010100000000
0000000000001000000000000000100000101000001000110010001000000000100000000001001111000100100000000100
0000000000000000000000100000100000010011000000000000000100100000000000001011010000000000000000000001