0000000000000000000000000000001011010000000001000111100000101101000100000011000101100100001010100000
1000100100010011100000100000101000000011000000000010100010000000001101000000000000010000001000101000
0100000100010001110100000000100000000000000010100100000101010000010010000010001100100001011000000000
0100000000000000000000000110000000000110010001101010000101100000010000011000010000010000001100000000
0000110011100010010000101001000100000000010000010011000000000000001100000001000000011010100000001000
0000110101000101100000000000000010000000000000100111000001010000010100010011000000100001010001000001
0010000000010000000011000000000101100101000000000000000000000000010000011000001010000100001001011100
1000000000001010000100011000001001001010000000001001000010000010000100010001110010000000000000100001
1000010010010010000010000100001000000001000010000000110110100100100110000000000000000010000000001000
1001000000001000000000000001110001000000000010001011100000100000101000010001010101010000000100000000
0000000001000010000000100010010101110100010000000001000100000000100001000001010000000010000000001000
1000100010001100000000000000000000100000000000000000000001001111010000111010000000000000100000000001
0000011010000000000001001000001001000000001000000000001000000000000010000000000000000000001000100001
1100000101000000000000000000010000000110000000000000100001110000000000001101000000000100010000000101
0010010000000101100010111000000000010000000100000100001000010010100000000001000000001000000000000001
0000100100000000001000000000000001100000010000100100000000000110110000000001010110001011000100010000
1000001110001001010010000000010000000000010000010000000010000010000100000000000010000000000000000011
0001000110010011100000000100000000000000100001111100000000000010000000011001000001000100100000100101
0010001000000111100001101000000000000100100010100000000000100000000010110010000001000010000000010000
0000000010000000000000000000111000000000000000110000010001100000000000001010000001101000101001100100
0110010000000010000000000000000110000000101001011000001001000000000010010000100010000100101000000011
0000000001001100000000000000010010000011001000000100100010000001000000000100011100001000001000000010
0100100011000100010010001000100010100100000100000000110000000101010000010010000000101000100100000000
0000001100100100010001010000100100100000100000000000000010010100000000000000001000000000001001100000
1000010100000100000000101010000000000110000000010000000011010000000000001000000010100000000100000000
0001000000000010100100000000000101000000101000101001100011000000000010000000000000111100111110100001
0000010110010000000000010100100101100100000000000000000000000100100000000000010000011000000001000000
0000000001100000000000000100000000001101000100111101010000010010001010000000110001000001101001110100
1000100000100000000000011000000000100100000111010000010010000000000010100000000100001010000001000100
0010010010100000000000000001100000000000001000000000000100000100000001000000111001100000101100000010
0001000000010000001011000000100000100000000000000010001000001110000010001010100000000000100100100110
0001001000010000000000010000000000000000000000000000000001000100100100001000000000000000010000000000
0010001000000000010001100000000010100101010000001100001010000011000001000100000000011000000000000100
0100000000000000000000000000000010110000000001000000100000000100010000000000000000001010001001000000
0000000001000011000101000011010100010000001000000000000000000000000110001010000000010000000010001000
0101010000010001000001000000000010000010001100000001000001101001010100100110001000000000100100101000
1000001001000000000000000000000000000000000000000001000110000010000000000001001000010010000010000101
0000100010100000110001100100100010000010000100001000000000010000000101100101100000001000000101100011
0000000000100100100001000000110000000000000000010000001101101000100000000010000110000001000001000001
0110000000000101000000000000101001110000010001010000000010001010101000101000000000010000000000001000
0000100010001100100001001100101100000000000000000100010010000000010001000001001000000101000000100001
0000110000000000000000000001000010100000010010110100000100110000000000101101000010000000000010001000
0000010011010011000000101110010000000000000010000001100101001000000001000100011000010000100000000011
0000100100001110000000100010010101000010000000010000000001000100000000100000000000000000000100000000
1100111000000000010100000001000010011000000000000001100000010000000000000001010000000000000010000000
1000101001000000010000010000001001000000000110000010000000000000011100110001010000000100000001001100
1100100000001101000000001000100010000000000000110000000100010001000101000100000000101001100110000001
0100001000000000000000000000000000001000000000011000010000000010001000100100000001010101000011000010
0000000000100000010001100000001000000000000010000000000100000010001000000001000001000000100001000010
0000000010010000001000000100100000000000011000000000010110000000100100010100010000000001000000000000
0000000010010001001000000100000011001010100011000010000000000001000000000001001010000000001110000000
0100000000100001000000000000010000000000000001010000011001000000000000100010110100100000000010010001
1000000000111001010100100010100101000000000000000010000000000100000100000010000000110001010000001100
1100001000000000000000010000000110000000001000000101000000100011000000010000000010000101001001010000
0010010011010100100000000011000000000010000000000000100000101000001001000000000000001001100000010000
0000000100100000000000100000010001000000100010001000101001001100000100000000000000000000000100000000
0100000000000000100100001000001010000000001010100000000000010000110100010000011000000010000000101000
0000001010001000000001000011000100000100010000010000101000000001100000000100110000001001100000000000
0001000001001100000000000000001010001000000000001100000001010000000001000001000000001010000010100000
0000010100000001000000111010001000100000000000010100010100000000000000010001010000010000111000000100
0001010000000000001000100000000010101000001001100000010000011010100000000000111000000010000010011001
0001010000100000001000000110001000100000100010000000000000000101000000100000000101001010000000000000
1000000000001000000110000001000100000000001001010000010000101000101000000000010110000000000001000111
1000010000000000010000001000010000000101000000010000000000000000000000000011001001100000000000100000
1000001000100101000100000000100000001000000000100000101000000010000000001001010001000000010000000010
0000000001001000000000001111000100110001000000000000001000010000100000000000010100000010000101000010
0001000000001000001011001100000000101000110100000100110010000000101001000000000001001010001110000000
0000001000001000000000000000010000000010000000101001000001001000000110000111000010010000100100101011
0010000001110111001000011000110010010100000100100000000000001000000010100100000010110111000000001001
0000000001000001000001100000001000000001010000000001100001000000000001001000101000010110001111010000
0000000000000000100000000000011000011100000000010101110000000001001000000000010000000000100000000000
1000100100000000000101001000100001000000000000000100000000000001000001001011100000010010000000001010
0000010000000000000001000000101000000110000000101110100100000100001010000000100000100001000000000100
0100000100100100001000000000000000000100000000000000000010000001010011100110000000100001110000000000
0000100000100000010000000000001100000001100100001000000000001000000010000000000100001000000010001000
1000000010100100000000000000000000000001000000001000000100100000100110101000100000100000001000001000
0000001000101000110010010000100000000000000000010000000000010000000000000010100000000100100000010000
0000000000100100000010000001000010010100010110000100000001000000001010000001100000100000100001011111
1101000001000001000010000001000000100000011000000010000000000000001000000100101000001001000000000000
0000000000111000100000011000000001000001100101000010001000110010000010000010101000000000000000010001
0000001000100000010000000000100101011000110100011100000000000011101000010111100001010010010110000000
0000000000010100100001000000000000000010000000000100000100000100100000100110100110000000000000000100
0000000000010000000110000010000000001011000010001000100001101100000010000000001100000000000010000001
0000100111001101010000001000010100001000000000110001001010010000100000010010010000000001000010010000
0000001100000010010100100010100000100000000110001011101000000101000101110010000000000101010000010010
0001010010000001000000010100101010010000000001100100010100000000001000000000001000110000000010000000
1000100000000000000000100100000001010000000100110000100000000000000000011010000100001100000000011000
0100010000000000000000001000001001000010000001000000000000000000000000100000100000000000001000100010
0110001001000000101001001000000000000101000000100100000001010010000000000010000000000100010000100000
0000100000010100110000110000000110110000100000010000100000001001000000000010000000001000010100100001
1101000100001000100100110000100101000111000001100101001000000000000000000000010010000011001000000011
0000000000000100010000000010000000000001010000010000101100000000000000100001000000010000010000000000
1101000100111000000000000001000001001000000010010000000000010000000000010000100000100100000000011000
0010010100000111000000000000000000000001000100010000010001000010000000111000010010100000000100000000
0000000101010000100100100000010100000000000000100010000000010000011010000000000100000001110000000100
0000000100000100000000010010001000010010000001000000100100000000000001010001000000010000000000000010
0000001000001000000100000000000000000000010010000101100000011000101000000011001101000010011001001000
0000000000010000000000000000000011010000000010000000000011001000010000000100100010000100001010100001
0100010100000100100010000001100000100101000000000010001100010000000110000001010000011011000000000100
0100010001010000100000000100110001110001010001010011000000010111000000010000000000110000001000000000